********
***X*X**
********
**X*X*XX
********
**X*XXX*
********
*X*X*XX*